0000000000
S111110000
0000010000
0000010000
0000010011
0000010010
0000010010
0000011110
0000000000
0000000000